6FMuGUVTP2FgYb7uRA1DxY	West Side Story: Act I: Prologue	-	Leonard Bernstein
4k4RPzuZ1nfPhHv0EE311D	West Side Story: Act I: Jet Song	-	Leonard Bernstein
3hdC2L3RnONF9WGgVTbX3N	West Side Story: Act I: Something's Coming	-	Leonard Bernstein
2PNEqN6aM9MDhpBpDMEU0a	West Side Story: Act I: Blues	-	Leonard Bernstein
6Lk4DFEidjTGLbWO4Gwose	West Side Story: Act I: Promenade	-	Leonard Bernstein
16RHpcDEggfVaUlYsLCkfv	West Side Story: Act I: Mambo	-	Leonard Bernstein
71VdG5lx0KGG52IF15ZA27	West Side Story: Act I: Maria	-	Leonard Bernstein
5jzP63vZKuShu11idshuLc	West Side Story: Act I: Balcony Scene / Tonight	-	Leonard Bernstein
1zI1Pjid5DIKlEwpE19SOy	West Side Story: Act I: America	-	Leonard Bernstein
1y5yKl2ZZZZenslNnjMqPR	West Side Story: Act I: Cool	-	Leonard Bernstein
5BGwxnPsqjkc4tEmYdDcUv	West Side Story: Act I: One Hand, One Heart	-	Leonard Bernstein
2XXSqdHpq123jSLTMop7ie	West Side Story: Act I: Tonight	-	Leonard Bernstein
5utou5U05hk9y8EceqLXPp	West Side Story: Act I: The Rumble	-	Leonard Bernstein
3w5y5ZcvX9bWqlMe70SOJr	West Side Story: Act II: I Feel Pretty	-	Leonard Bernstein
7ceJBnPip2CzhGWcTfYKQs	West Side Story: Act II: Ballet Sequence	-	Leonard Bernstein
7LkkRBPErH4p0zXDbAlIj1	West Side Story: Act II: Transition to Scherzo	-	Leonard Bernstein
47Q2mOBUHjHTyI4wTM6YsA	West Side Story: Act II: Scherzo	-	Leonard Bernstein
4IYLgBomlGJmbLiRYMWbxE	West Side Story: Act II: Somewhere	-	Leonard Bernstein
1FHLViOztvKcfjcRkRR2Ld	West Side Story: Act II: Procession and Nightmare	-	Leonard Bernstein
5qM1XKUkxmuElk003lRBbo	West Side Story: Act II: Gee Officer Krupke	-	Leonard Bernstein
37PKvo0X0MmlVa1VLiQxSC	West Side Story: Act II: A Boy Like That / I Have a Love	-	Leonard Bernstein
0v8Vw39GFqSJIps8Mr9uYp	West Side Story: Act II: Taunting Scene	-	Leonard Bernstein
7pxaMPiMj30dnmI9jJmWmc	West Side Story: Act II: Finale	-	Leonard Bernstein
