4FBvJWYrvHG3azcVEV5UQf	20th Century Fox Fanfare	-	John Williams
5Fj5ktrJUUWZ5mGxoTQZMs	20th Century Fox Fanfare	-	John Williams
1FCt4kLO0JEuyUAuZRM2IX	20th Century Fox Fanfare	-	John Williams
0XERV56BCuGRfQQwxRpV1Q	Parade of the Ewoks	-	John Williams
7GwLqpq3z932KLWZN5Qrwb	Princess Leia's Theme	-	John Williams
1eTEfRxuZtNGwQT6I2Vs35	Star Wars Main Title and the Arrival at Naboo	-	John Williams
361EjKG8r9wZY85CfsbRuk	The Imperial March - Darth Vader's Theme	-	John Williams
6JYPEVgJCWbNFXPSvwOxVX	Luke and Leia	-	John Williams
1YvVHsvwvZhHTPv7ZeSfck	Main Title/Approaching The Death Star/Tatooine Rendezvous - Medley	-	John Williams
5dV0LMya1Za2EtzJjOsHqe	Main Title/Rebel Blockade Runner - Medley	-	John Williams
2SlYBdtQyIv0XJ1JJbpXdj	Main Title/The Ice Planet Hoth - Medley	-	John Williams
7DdRSR10a5hH9Kkx3Ozkpo	The Flag Parade	-	John Williams
3d3d9JGowe6lVBdGaQ3eE8	The Millennium Falcon/Imperial Cruiser Pursuit - Medley	-	John Williams
3WlFYAdsnj90vkUwDfgXOq	Yoda's Theme	-	John Williams
5IHtxPks0YpkgyJ01YeqMQ	Brother and Sister/Father and Son/The Fleet Enters Hyperspace/Heroic Ewok - Medley	-	John Williams
700tSasfV7EecUa8WHl745	Destruction of Alderaan	-	John Williams
6DIKvm7WKg6SacdwmvcAa3	Imperial Attack	-	John Williams
77rbR97xiRfMhS2sJJD01F	Qui-Gon's Noble End	-	John Williams
17YkE1tfUudbSnIst6SUZ1	The Droids Are Captured	-	John Williams
4lxwRzwSbLBeZj6wo5cCEC	The Wampa's Lair/Vision of Obi-Wan/Snowspeeders Take Flight - Medley	-	John Williams
03cKjDcuXvdW2IgfIvivT8	Bounty for a Wookiee	-	John Williams
2t8yn1LcrBdXtb5KwoMPGd	Emperor's Throne Room	-	John Williams
4d9EOYTDHkS0ahQ0eo5U0s	Jango's Escape	-	John Williams
0pZkNMf5N0NfYaVgLo5dR9	The Death Star/The Stormtroopers - Medley	-	John Williams
3CN0nTOXn3zJgRIVKBAI59	The Dune Sea of Tatooine/Jawa Sandcrawler - Medley	-	John Williams
4PTDZgiYjzJ2R6FWPGyyXR	The Imperial Probe/Aboard the Executor - Medley	-	John Williams
4AHpPaezjfkNyPHHWrOpDu	Yoda and the Force	-	John Williams
74VIlcAZXeKCUq6G608leM	Han Solo Returns	-	John Williams
5JqseMUWj9ByCBc0rA2D6t	Imperial Starfleet Deployed/City in the Clouds - Medley	-	John Williams
7K31jubORxfr0d7zLEWVhM	The Battle Of Endor I - Medley	-	John Williams
1pkLT7d2NrHGT7TWsheTh1	The Battle of Hoth - Medley	-	John Williams
2Buf4750ofcm3MVH3zBq06	The Moisture Farm	-	John Williams
2loBMUFYim8yDGdaGHst5e	Wookie Prisoner/Detention Block Ambush - Medley	-	John Williams
0v155gWnlz45bkQzbEHyRV	Yoda and the Younglings	-	John Williams
7wXXLony4yajevhn5osM7U	General Grievous	-	John Williams
6GYnCjUGXvfEMc8E7rq3rZ	Lando's Palace	-	John Williams
3PKNZyYMeGoNKvA9r9Tuik	Luke Confronts Jabba/Den Of The Rancor/Sarlacc Sentence - Medley	-	John Williams
7qbCgkHAF8X9ZOHs2vQ3Vd	Shootout in the Cell Bay/Dianoga - Medley	-	John Williams
1Nj8SC8mRH3MOw41WJeduv	The Asteroid Field	-	John Williams
5NX6wUnPvjcxcB7VxDJqyf	The Hologram/Binary Sunset - Medley	-	John Williams
4XGnLkaawnQbARljRasx1U	The Lightsaber/The Ewok Battle	-	John Williams
1acc6W4NGGyBVRYSpRS3Rl	Landspeeder Search/Attack of the Sand People - Medley	-	John Williams
11i6zpf5wdNWuW6oc4bIK4	The Battle Of Endor II - Medley	-	John Williams
0STdXKLqxvoSwkPuaJtgqB	The Pit of Carkoon/Sail Barge Assault - Medley	-	John Williams
5gl3NgMv4wT7Fw4CGEXHO9	The Trash Compactor	-	John Williams
1lavj4cUmomVIh14dyZfZz	Deal with Dark Lord	-	John Williams
6kZIsAsML8JCh732psPcYc	Imperial Attack	-	John Williams
3rHhOuarTq6Cft2a3yoxLa	Luke's Nocturnal Visitor	-	John Williams
3D28xn1KL25T51nae51Bi9	Tales of a Jedi Knight/Learn About the Force - Medley	-	John Williams
3Pg2zh2TdMLDbS88wBxqb2	The Battle Of Endor III - Medley	-	John Williams
2UpX7mXyVSZB7AYKOOGHcz	The Emperor Arrives/The Death of Yoda/Obi-Wan's Revelation - Medley	-	John Williams
6Y8ch9jt4RHiBHveWnUJ88	The Tractor Beam/Chasm Crossfire - Medley	-	John Williams
4f1OAEdAjNbSTymBa9ZHVn	Burning Homestead	-	John Williams
3T1flKNl9oDP9B6PB4Ygii	Carbon Freeze/Darth Vader's Trap /Departure of Boba Fett - Medley	-	John Williams
2OYpqele0GNXHg3JradQK1	Han Solo and the Princess	-	John Williams
0vdQ0H6Vb7tD91RYKX8T6B	Leia's News/Light of the Force - Medley	-	John Williams
6h8plLiP2wNay2bcnwPNYy	Jedi Master Revealed/Mynock Cave - Medley	-	John Williams
3diF1mpB3yITF1DeD8MOGV	Mos Eisley Spaceport	-	John Williams
4Tgzkjrza5RYh24eHeRyce	Shuttle Tydirium Approaches Endor	-	John Williams
1LqqEnQFilnoFZJg2GnqSV	The Battle of Yavin	-	John Williams
6Rwr0Lq9gqD95KHEdy4Ji3	The Clash of Lightsabers	-	John Williams
3VmU49ThIV3jom0juzQa9R	Victory Celebration/End Title - Medley	-	John Williams
2ek7uGltLctsUegtA3T4Aw	Yoda and the Force	-	John Williams
0cCM6fMdP6d122x2oNYS7v	Cantina Band	-	John Williams
0qKB12kicHmdvIzzONv9wn	Ewok Feast/Part of the Tribe - Medley	-	John Williams
5gb2EBtGcPnkqRa5No52uq	Rescue from Cloud City/Hyperspace - Medley	-	John Williams
52lIC9HnWrS0abmtaWodzi	Speeder Bike Chase/Land of the Ewoks - Medley	-	John Williams
37YFqG3E4Sa9SwBd68IqMT	The Clash of Lightsabers	-	John Williams
5yThzvTsMz3zM1tmwn23Po	The Throne Room/End Title - DVD Video/Medley	-	John Williams
0UXR0wTYnZFcVNXmBNMCzr	The Training of a Jedi Knight/The Magic Tree - Medley	-	John Williams
7dNR5dkbMORQlHdnIpwMhh	Cantina Band #2	-	John Williams
3mBX7TwZ14nMQotPU7C06b	Sail Barge Assault	-	John Williams
4njDST3Y0cjv28EIAJIy7Z	The Forest Battle (Concert Suite)	-	John Williams
1IvlmBoPA4mwglJiRGaDAl	The Levitation/Threepio's Bedtime Story - Medley	-	John Williams
14P0XNI1iny3pwuBmGUzRw	The Rebel Fleet/End Title - Medley	-	John Williams
4qXAQNLmVqdZI5ifCTj2DB	End Title from "Star Wars Episode VI"	-	John Williams
2o4qO7UPRrqKBIuauEs0II	Jabba's Baroque Recital	-	John Williams
3bZ5AKmr34J9w8MRtmpm4s	Jedi Rocks	-	Jerry Hey
3F5fDsEb0hiRfik3J2yC4T	Sail Barge Assault (Alternate) - Alternate Version	-	John Williams
73dadTiaNN7WVqpr14GdpC	Anakin is Free - Instrumental	-	John Williams
3rFqNpBW3yC10DS30EIfij	Fox Fanfare - Instrumental	-	John Williams
4kKa7yjaowTCUoG9hZ3bXa	Qui-Gon and Darth Maul Meet - Instrumental	-	John Williams
5YjsRzUGoBklPQH5A9NnQD	Star Wars Main Title - Instrumental	-	John Williams
6qiOxvAcrfAAgCkdLAMYn6	Anakin and Group to Coruscant - Instrumental	-	John Williams
13LgrnRHH1pd2YnATSGVOo	Boarding the Federation Battleship - Instrumental	-	John Williams
61BiHixazQ0AK3rUg2HxmM	Death Warrant for Qui-Gon and Obi-Wan - Instrumental	-	John Williams
416dKbdBHVhGV2wVBxo4oN	The Queen and Palpatine - Instrumental	-	John Williams
69dRdSJC28W26OPs0PbVLz	Fighting the Destroyer Droids - Instrumental	-	John Williams
625AzzQn7k8ohHECPz7Ek3	High Council Meeting - Instrumental	-	John Williams
6du5UZmkJABZ7Ep1mhcHMe	Queen Amidala Warns the Federation - Instrumental	-	John Williams
4PfsNnQu0Kdb0vqMePxmpU	The Senate - Instrumental	-	John Williams
1L2UiBkJUnkVXuoUp700F9	Anakin's Test - Instrumental	-	John Williams
3ma4EPfZlMBJv9A4tKanWH	The Droid Invasion - Instrumental	-	John Williams
3ulg3DlejvYKw1Q4Dr5eWt	Qui-Gon's Mission - Obi-Wan's Warning - Instrumental	-	John Williams
4bjxFQVRbr6wTwK5tt7jxv	Swimming to Otoh Gunga - Instrumental	-	John Williams
1ONnZlEELqDyp9W9iAAWEw	Inside the Bubble City - Instrumental	-	John Williams
7bAiTrxgm0l75SHPQsavej	Nute and Rune Confer with Darth Sidious - Instrumental	-	John Williams
0k7XuoPDOKceeaf6WnVuhD	Attack of the Giant Fish - Instrumental	-	John Williams
56eKOKWeMQviHHhkNfkO4E	The Queen and Group Land at Naboo - Instrumental	-	John Williams
5XdFdBrBplK8FJKXZIfqxd	Darth Sidious - Instrumental	-	John Williams
3Oci4MaEqQOGpPHUYP7Vtk	Jar Jar Leads Group to the Gungans - Instrumental	-	John Williams
33A2bXzpGzOFeHaMYJ8r5I	The Giant Squid and the Attack on Theed - Instrumental	-	John Williams
0jdhX9CYbwvbTQvkyf1ANR	War Plans - Instrumental	-	John Williams
4E5xZmKcNkhqZbDZ2F2cPs	Darth Sidious Receives News of the Gungan's Army - Instrumental	-	John Williams
4QWrOv4cXSTDgRKIhcxcBW	Qui-Gon and Obi-Wan Rescue the Queen - Instrumental	-	John Williams
7LbgPrfNiEuL8BlUizbsaX	Fighting the Guards - Instrumental	-	John Williams
1vrohzexxIFpsEEh9Rl4Ae	The Gungan's March - Instrumental	-	John Williams
3qBJAPzIMQZrf8KerODh1S	Escape from Naboo - Instrumental	-	John Williams
529ldA4iICTPVH8REM4whF	The Queen and Her Group Sneak Back to the Palace - Instrumental	-	John Williams
2elco9mh18eCB2fxPs5EZt	Enter Darth Maul - Instrumental	-	John Williams
1k0ksrm58Ncu3faSLyvWXu	The Battle Begins - Instrumental	-	John Williams
2vnKNAEnuvZ8AXzdma4WpO	The Arrival at Tatooine - Instrumental	-	John Williams
00PBac4gCqWGmC7reMoHwP	The Republic Pilots Take Off Into Space - Instrumental	-	John Williams
3sVmtIVwpNtHQUbOEKWtdG	Activate the Droids - Instrumental	-	John Williams
461xbNz5q5SpxYYLHOJyFE	Street Band of Mos Espa - Instrumental	-	John Williams
1DUVh97a2jTmT1Y6JRZHX1	Padme Meets Anakin - Instrumental	-	John Williams
4xhnupa5YzF8V2JzuQf1wc	The Gungans Fight Back - Instrumental	-	John Williams
3oSFTAtisGA1okKpG8h48B	Desert Winds - Instrumental	-	John Williams
6Tk30WHk0Cgy7EPrVP3CYC	The Duel Begins - Instrumental	-	John Williams
4UIHjZyK39K5FIDyfdOQtr	Anakin Takes Off In Spaceship - Instrumental	-	John Williams
4qkAZv3KYKuQPNgTTjDPnr	Jar Jar's Run In with Sebulba - Instrumental	-	John Williams
0d2uJYS0Us2jaSMCMdDddk	Anakin's Home and the Introduction to Threepio - Instrumental	-	John Williams
3qkufYZUC8vWptEMsWfC3N	The Duel Continues - Instrumental	-	John Williams
3wIyPjYD7IaounQpCmSHwu	Darth Sidious and Darth Maul - Instrumental	-	John Williams
7wrvmtYCqtExjPoN1Lfc3Q	The Battle Rages On - Instrumental	-	John Williams
3ULaPf0icAh0SoD4h7C5SE	Qui-Gon, Obi-Wan and Darth Maul Continue Battle - Instrumental	-	John Williams
3KPo6BUvNE8JhKZcbdKSV8	Talk of PodRacing - Instrumental	-	John Williams
7uv76OoGtSomm86SUusDM5	Qui-Gon, Darth Maul, and the Invisible Wall - Instrumental	-	John Williams
5zvwb31SMtc9gbb7qnzO6z	Watto's Deal - Shmi and Qui-Gon Talk - Instrumental	-	John Williams
5r01sNnzljtnAPNiwqVwxj	Anakin, PodRacer Mechanic - Instrumental	-	John Williams
0xafYLpkEzw77upXoxooBG	The Gungan's Retreat and the Queen Surrenders - Instrumental	-	John Williams
1MUyyGFFjFddYKf2jOsrXs	The Death of Qui-Gon and the Surrender of the Gungans - Instrumental	-	John Williams
1IAkY1RouQmHqDB39pTcYr	The Racer Roars to Life - Anakin's Midi-Chlorian Count - Instrumental	-	John Williams
1yBTXx35GhMDrVvSeP1mod	Darth Maul and The Sith Spacecraft - Instrumental	-	John Williams
20rsprOnyFPH9sv4yeLR7C	The Tide Turns - The Death of Darth Maul - Instrumental	-	John Williams
2had4eEwqYr4ReZrZpCv1w	Mos Espa Arena Band - Instrumental	-	John Williams
024Lb6khiclXJ5dKyjCjBb	The Queen Confronts Nute and Rune - Instrumental	-	John Williams
5ovtNluu7z9Y5nBQvnRiRD	The Funeral of Qui-gon - Instrumental	-	John Williams
1cbnYWuCNi0udWU3gGhZak	Watto's Roll of the Die - Instrumental	-	John Williams
6jzHS3AWlEfljmO5lov2UL	The Flag Parade - Instrumental	-	John Williams
0hyOxIdjitrJ2WIK1WhA7b	The Parade - Instrumental	-	John Williams
54JHUVAYS5Hsz73RcKialv	End Credits - Instrumental	-	John Williams
6L5QnGMKYOD8IJXDKr448Z	Sebulba's Dirty Hand - Qui-Gon's Pep Talk - Instrumental	-	John Williams
6vroS2JyemZbhMS7zffPYl	Anakin Defeats Sebulba - Instrumental	-	John Williams
1vAN306kJizc0YcfInn0Qe	Duel of the Fates (Dialogue Version) - Instrumental	-	John Williams
1wdnPTEOSTL3XruTTufz9l	Hail to the Winner, Anakin Skywalker - Instrumental	-	John Williams
6RepUXDe101oLFmQcDz7Qo	The Street Singer - Instrumental	-	John Williams
0UQs3YncwYddGxsXcE21rH	20th Century Fox Fanfare	-	John Williams
3AMV0xXxSSKXaioctL4lo6	Princess Leia's Theme	-	John Williams
28ou83qz1gPebqVJus8nuc	Main Title / Rebel Blockade Runner	-	John Williams
20Cv2RKKNxuvxQbQeYhY2m	The Millennium Falcon / Imperial Cruiser Pursuit	-	John Williams
7elVeDGM7k1UK3PStBDrac	Destruction Of Alderaan	-	John Williams
3iMrYhM0jJF02Xef79zw5v	Imperial Attack	-	John Williams
0oL8aRHNmyK07ciZlHogD7	The Death Star / The Stormtroopers	-	John Williams
0RbrajKSW4mED7n7Um2wsL	The Dune Sea of Tatooine / Jawa Sandcrawler	-	John Williams
0RLxggRxzlGXUoNHePJdj6	The Moisture Farm	-	John Williams
5jZjWwIR3khrD8zyBQXGvh	Wookie Prisoner / Detention Block Ambush	-	John Williams
05C9BAKi8kwrwRve6Her6O	Shootout in the Cell Bay / Dianoga	-	John Williams
4IkCtDnBLjxd4UYUEoXOtx	The Hologram / Binary Sunset	-	John Williams
5QYH4gzO7htFpvVUjcysSG	Landspeeder Search / Attack of the Sand People	-	John Williams
7BxRrKGJIX88IvDD56Zwp2	The Trash Compactor	-	John Williams
6orzVFhuWKxHFDTadmdIJM	Tales of a Jedi Knight / Learn About the Force	-	John Williams
6hupIPQ7AItPWoRQMHnKAF	The Tractor Beam / Chasm Crossfire	-	John Williams
27oNyK7KjNUGf37PGMqAIw	Ben Kenobi's Death / TIE Fighter Attack	-	John Williams
65k2oP3yYxJNFbZ0q93Kss	Burning Homestead	-	John Williams
50lKndICCkzCCAlyllswLX	Mos Eisley Spaceport	-	John Williams
7FfUfnRHEw7UXDo2KcGDBK	The Battle Of Yavin	-	John Williams
14MAez2sDF4dSkqzUQrDb1	Cantina Band	-	John Williams
3LT9jNyGOiyENhsPkLrjm6	The Throne Room / End Title	-	John Williams
2tWYo4Pcht40q0yaRmXGzB	Cantina Band #2	-	John Williams
4fbaM8XeP9jAHw3jbxt02Q	Binary Sunset - Alternate	-	John Williams
