4ETKM3bvxTM3pVCgz8pzcJ	Prologue: Work Song	-	Les Misérables - Original London Cast
3gBGCemEeXMqeC5Rw2EL6m	Prologue: Valjean Arrested/Valjean Forgiven	-	Les Misérables - Original London Cast
6zib19PK2PEwAcBxESP0WD	Prologue: What Have I Done?	-	Les Misérables - Original London Cast
2wYXLVWNcqC7Cxlw92aCtK	At The End Of The Day	-	Les Misérables - Original London Cast
13LT9Y0RP7C9KhNIvroXLi	I Dreamed A Dream	-	Les Misérables - Original London Cast
6mMiGHG6JuMrowGkafuXls	Lovely Ladies	-	Les Misérables - Original London Cast
40KBTAVPWIYUBwELheOZ1C	Who Am I?	-	Les Misérables - Original London Cast
6tFKrRGF8PRaelGOzxJ5cs	Come To Me	-	Les Misérables - Original London Cast
4B8kmpqV18wXTI07q0m1Bc	Confrontation	-	Les Misérables - Original London Cast
5CQaqSeXCgHbhfsQg5Nctj	Castle On A Cloud	-	Les Misérables - Original London Cast
6cX9HbjCK20dfd5C1fftUE	Master Of The House	-	Les Misérables - Original London Cast
3Uftn3QCsD3lg79FuKcbE1	Thenardier Waltz	-	Les Misérables - Original London Cast
2bQI6Wh9v6SoOjfiKb18G5	Stars	-	Les Misérables - Original London Cast
2koYHPmR7nERQx7JQgrcii	Look Down	-	Les Misérables - Original London Cast
5fbFyzSoU80kwqUF7JlV2F	Little People	-	Les Misérables - Original London Cast
1lhdGCE8MgiUi7sMoSZi82	Red & Black	-	Les Misérables - Original London Cast
1SFSlwDclv0wT7p8aMsBM1	Do You Hear The People Sing?	-	Les Misérables - Original London Cast
4q8Hw7k5tpe1AALlTVgKyS	Love Montage: I Saw Him Once/In My Life/A Heart Full Of Love	-	Les Misérables - Original London Cast
1cHv0FqSU4yaOY0QzZayuX	Plumet Attack	-	Les Misérables - Original London Cast
6cdcZzuQzUhspZo2aJfKaH	One Day More	-	Les Misérables - Original London Cast
6cs44cWPd4652NlIrzRqNx	On My Own	-	Les Misérables - Original London Cast
5HZ0RxnwRK9bkmxnwKTAJn	The Attack	-	Les Misérables - Original London Cast
3SeYUKgbfYg6ZLLbhwzF9t	A Little Fall Of Rain	-	Les Misérables - Original London Cast
5D2mHuaTpubjIGtrtQ0uQ1	Drink With Me	-	Les Misérables - Original London Cast
5kWVIa5k3M3kt5MBcayVMb	Bring Him Home	-	Les Misérables - Original London Cast
7sOTi9bOYSHCGqy0KClraf	Dog Eats Dog	-	Les Misérables - Original London Cast
5VxaHVcDLbRKn4jMa5kKKc	Javert's Suicide: Soliloquy	-	Les Misérables - Original London Cast
7dytzjO9B0BYQAVQ4fu8qf	Turning	-	Les Misérables - Original London Cast
7gEEBjoa8kbp8NJnXuLVf6	Empty Chairs At Empty Tables	-	Les Misérables - Original London Cast
4yuixCIFG0VguSqw5uLnHN	Beggars At The Feast	-	Les Misérables - Original London Cast
2J6cFPp3jlASjitfkSzA9W	Finale	-	Les Misérables - Original London Cast
